{
  "DOC - Documentación inapropiada": [
    "ODP-05",
    "ODP-02",
    "TMD-01",
    "ODP-01",
    "ODP-03",
    "ODP-04",
    "ODP-06",
    "ODP-07",
    "ODP-08",
    "ODP-09",
    "ODP-10",
    "ODP-11",
    "ODP-12",
    "ODP-13",
    "ODP-14",
    "TMD-02",
    "TMD-03",
    "TMD-04",
    "TMD-05"
  ],
  "PRO - Procedimientos de mantenimiento incorrectos": [
    "ODP-05",
    "OPR-02",
    "HCS-01",
    "ODP-01",
    "ODP-02",
    "ODP-03",
    "ODP-04",
    "ODP-06",
    "ODP-07",
    "ODP-08",
    "ODP-09",
    "ODP-10",
    "ODP-11",
    "ODP-12",
    "ODP-13",
    "ODP-14",
    "OCS-03",
    "TMA-01",
    "TMA-02",
    "TMA-03",
    "TMA-04",
    "TMA-05",
    "TMA-06",
    "TMA-07",
    "TMA-08",
    "TMA-09",
    "TMA-10",
    "TMA-11",
    "TMA-12",
    "TMA-13",
    "TMA-14",
    "TMA-15",
    "CCM-01",
    "CCM-02"
  ],
  "GH - Operaciones inadecuadas en tierra": [
    "TAO-05",
    "HCS-01",
    "OEP-01",
    "TAO-01",
    "TAO-02",
    "TAO-03",
    "TAO-04",
    "TAO-06",
    "TAO-07",
    "TAO-08",
    "TAO-09",
    "TAO-10",
    "TAI-01",
    "TAI-02",
    "TAI-03",
    "TAI-04",
    "TAI-05",
    "TAI-06",
    "TAI-07",
    "TAI-08",
    "TAI-09",
    "TAV-01",
    "TAV-02",
    "TAV-03",
    "TAV-04",
    "TAV-05",
    "TVA-06",
    "TAV-07",
    "TAV-08",
    "TAV-09",
    "TAV-10",
    "TAV-11",
    "TAV-12",
    "TRO-01",
    "TRO-02",
    "TRO-03",
    "TRO-04",
    "TRO-05",
    "TRO-06",
    "TRC-01",
    "TRC-02",
    "TRC-03"
  ],
  "MDA - Mantenimiento deficiente de aeronaves": [
    "TMF-11",
    "TMF-10",
    "TMF-09",
    "TMA-01",
    "TMA-02",
    "TMA-03",
    "TMA-04",
    "TMA-05",
    "TMA-06",
    "TMA-07",
    "TMA-08",
    "TMA-09",
    "TMA-10",
    "TMA-11",
    "TMA-12",
    "TMA-13",
    "TMA-14",
    "TMA-15",
    "TMF-12",
    "TMM-01",
    "TMM-02",
    "TMM-03",
    "CCM-01",
    "CCM-02"
  ],
  "HAN - Problemas con las instalaciones del hangar, taller o base auxiliar de mantenimiento": [
    "TAF-06",
    "TMF-05",
    "TMF-04",
    "TOF-01",
    "TOF-02",
    "TOF-04",
    "TOF-05",
    "TOF-06",
    "TOF-07",
    "TOF-08",
    "TOF-09",
    "TOF-10",
    "TOF-11",
    "TOF-12",
    "TOF-13",
    "TMF-01",
    "TMF-02",
    "TMF-03",
    "TMF-06",
    "TMF-07",
    "TMF-08",
    "TAF-01",
    "TAF-02",
    "TAF-03",
    "TAF-04",
    "TAF-05",
    "TAF-07",
    "TAF-08",
    "TAF-09",
    "TAF-10",
    "TAF-11",
    "TAF-12",
    "TAF-13",
    "TNF-01",
    "TNF-02",
    "TNF-03",
    "TNF-04",
    "TNF-05",
    "TNF-06"
  ],
  "HER - Uso de herramientas inapropiadas": [
    "TMT-02",
    "TMT-05",
    "TMT-01",
    "TMT-03",
    "TMT-04",
    "TMT-06",
    "TMT-07",
    "TMT-08"
  ],
  "FOD - Foreing Object Debris/Damage": [
    "TAO-06",
    "OMN-08",
    "TRC-01",
    "TRC-02",
    "TRC-03",
    "TAO-01",
    "TAO-02",
    "TAO-03",
    "TAO-04",
    "TAO-05",
    "TAO-07",
    "TAO-08",
    "TAO-09",
    "TAO-10",
    "TRO-01",
    "TRO-02",
    "TRO-03",
    "TRO-04",
    "TRO-05",
    "TRO-06"
  ],
  "FH - Factores humanos como; aspectos psicosociales e incapacidad evidente del personal técnico": [
    "ODP-01",
    "HCS-01",
    "HSI-01",
    "HDI-01",
    "HIL-01",
    "HSL-01",
    "HSS-01",
    "HPS-01",
    "HTR-01",
    "HEO-01",
    "HMM-01",
    "HCC-01",
    "HCS-02",
    "OTR-01",
    "OTR-02",
    "OTR-03",
    "OTR-04",
    "OTR-05",
    "OTR-06"
  ],
  "ALM - Almacenamiento inadecuado de componentes": [
    "HCS-01",
    "TMF-12",
    "TMF-10",
    "TMF-03",
    "TMF-04",
    "TMF-05",
    "TMF-06",
    "TMF-07",
    "TMF-08"
  ],
  "DGA - Daños graves causados a una aeronave durante las actividades de mantenimiento": [
    "HCS-01",
    "TMA-01",
    "TMA-02",
    "TMA-03",
    "TMA-04",
    "TMA-05",
    "TMA-06",
    "TMA-07",
    "TMA-08",
    "TMA-09",
    "TMA-10",
    "TMA-11",
    "TMA-12",
    "TMA-13",
    "TMA-14",
    "TMA-15",
    "TMF-11",
    "TMF-10",
    "TMF-12"
  ],
  "GAR - Requerimientos de garantía por servicios deficientes": [
    "TMF-10",
    "QAS-01",
    "QAS-02",
    "QAS-03",
    "QAS-04",
    "QAS-05",
    "QAS-06",
    "QAS-07",
    "QAS-08",
    "TMM-01",
    "TMM-02",
    "TMM-03",
    "CCM-01",
    "CCM-02"
  ]
}